BOOLEAN	B UW L IY AH N
BREAK	B R EY K
BYTE	B AY T
CASE	K EY S
CHAR	CH AA R
CLASS	K L AE S
CONTINUE	K AH N T IH N Y UW
DEFAULT	D IH F AO L T
DO	D UW
WHILE	W AY L
WHILE(2)	HH W AY L
DOUBLE	D AH B AH L
ELSE	EH L S
IF	IH F
ENUM	AH N AH M
EXTENDS	IH K S T EH N D Z
FINAL	F AY N AH L
FINALLY	F AY N AH L IY
FLOAT	F L OW T
FOR	F AO R
FOR(2)	F ER
FOR(3)	F R ER
IMPLEMENTS	IH M P L AH M AH N T S
IMPORT	IH M P AO R T
INSTANCEOF	IH N S T AE N S IY AH F
INT	IH N T
INTERFACE	IH N T ER F EY S
INTERFACE(2)	IH N ER F EY S
LONG	L AO NG
PUBLIC	P AH B L IH K
STATIC	S T AE T IH K
VOID	V OY D
PRIVATE	P R AY V AH T
PROTECTED	P R AH T EH K T IH D
STRICTFP	S T R IH K T
SUPER	S UW P ER
SWITCH	S W IH CH
VOLATILE	V AA L AH T AH L
THROW	TH R OW
THIS	DH IH S
SYNCHRONIZED	S IH NG K R AH N AY Z D
TRANSIENT	T R AE N ZH AH N T
THROWS	TH R OW Z
SHORT	SH AO R T
RETURN	R IH T ER N
RETURN(2)	R IY T ER N
TRY	T R AY
CATCH	K AE CH
NULL	N AH L
NATIVE	N EY T IH V
PACKAGE	P AE K AH JH
PACKAGE(2)	P AE K IH JH
DEFAULT	D IH F AO L T
ABSTRACT	AE B S T R AE K T
TILDE	T IH L D
ACUTE	AH K Y UW T
EXCLAMATION	EH K S K L AH M EY SH AH N
ATTHERATE	AE T TH AH R EY T
HASH	HH AE SH
DOLLAR	D AA L ER
DOLLAR(2)	D AO L ER
PERCENT	P ER S EH N T
CARET	K AE R AH T
AMPERSAND	AE M P ER S AE N D
ASTERISK	AE S T ER IH S K
PARENTHESIS	P ER EH N TH AH S IH S
CURLYBRACKET	K ER L IY B R AE K AH T
BRACKET	B R AE K IH T
PIPE	P AY P
BACKSLASH	B AE K S L AE SH
FORWARDSLASH	F AO R W ER D S L AE SH
COLON	K OW L AH N
SEMICOLON	S EH M IY K OW L AH N
DOUBLEQUOTESYMBOL	D AH B AH L K W OW T S IH M B AH L
SINGLEQUOTE	S IH NG G AH L K W OW T
ANGLEBRACKET	AE NG G AH L B R AE K AH T
COMMA	K AA M AH
DOT	D AA T
QUESTIONMARK	K W EH S CH AH N M AA R K
EQUALSYMBOL	IY K W AH L S IH M B AH L
LESSTHAN	L EH S TH AH N
GREATERTHAN	G R IY T AH R TH AH N
HYPHEN	HH AY F AH N
UNDERSCORE	AH N D ER S K AO R
SEMICOLON	S EH M IY K OW L AH N
ONE	W AH N
ONE(2)	HH W AH N
TWO	T UW
THREE	TH R IY
FOUR	F AO R
FIVE	F AY V
SIX	S IH K S
SEVEN	S EH V AH N
EIGHT	EY T
NINE	N AY N
ZERO	Z IY R OW
PLUS	P L AH S
ENTER	EH N T ER
ENTER(2)	EH N ER
BACKSPACE	B AE K S P EY S
A	AH
A(2)	EY
B	B IY
C	S IY
D	D IY
E	IY
F	EH F
G	JH IY
H	EY CH
I	AY
J	JH EY
K	K EY
L	EH L
M	EH M
N	EH N
O	OW
P	P IY
Q	K Y UW
R	AA R
S	EH S
T	T IY
U	Y UW
V	V IY
W	D AH B AH L Y UW
X	EH K S
Y	W AY
Z	Z IY
STR	EH S T IY R
ARR	AE R
POS	P AA S
POS(2)	P IY OW EH S
TURN	T ER N
